WEEEEEEEWWEWEWEEEWEEWEEEEWEWWEEEEEEWWWWWEEEEWEWEWEEWWEEWWWEWWEEEEEWWEEWEEEWWWEEEEEWEWEEEWWEEEWEEWEEEEEWEEWWEWEEWWWWWWEWWEEEWWEEWEEEWEEEWEEWW
EWWWWWWEEEWEWEWWEWWWEWWWEWEWEWWWWWEEEEEEWWWEWEEWEWEEEWEEEWEEEWWWWEEWWEEWWEEEEWWWWEWEEWWEEEWWWEWEEWWWWWEWEEEWEWEEEEEEWEEEWWEEEWWEWWEEWWWEWEEE
WEEEEEEWWWEWEWEWWEWWEWEEWEEWEWEWWEEWWWWWWEWEWEWWEWEWWWWWWEWWWEWEEEWEWWWEEWWWWEWEEWEWWEEWWWWEEEWWWEWEWEEWWWWEEWEWWWWWEEWWEWWWWWWEWWEWWEEEWEWW
EWWWWWEWEWEEWWEWWEEEWEWWEWWEWWEWEWWEEEWEWEWEWEWEWEWEEWEWEWEEEWEWWWWEWEWWEWWEWWEWWWEEEWEEWWEWWWEEWEWEEWWWEEWWEWEEWWEWWWEWEEEEEEEWWEWWEWWWEWWE
EWEEEWEWWEWWEEWEEWWWEEWEEWEEWWEWEWEEWWEWWEWWEWWEWEWEWWEWEWWWWEWEWWEEWWEEWEWEWEEWEEWWWWWWEEWEEWEWEWEEWEWEEWEWWEWWEEWEWEWEWWWWWWWEWEWEEWWEWEEE
EWWWEWEEWEEEWWWWEWWWWWWWEWWEEEWEWEWEEWEEWEWWEWEWEWWEEWEWEEWEEWWEWEWWWWWEWEEWEWEEWEEEEEEWWEWWEWWWEWWWEWEWWEWEWEWEWEWEEWWEWEEEEWEWEWEWWEEWWWWE
EWEEWEWWEWWWWEEWWEEEWEEWEWWEWWWEWEWWWWEWEWEEEWEWEWEEWWWEEWEWWEWEWEWEEEWWEWWWEWEWWWWWWWWEWEWEWEEEEWEEWWEWEWEEWWWEWWEEWEWEWEWWWEWWEWWEWEWEEWEE
EEWEWEEWEEWWEWEEWWWEWWEEWEEWWEWEWEEEEWEWEWWWEWEWEWWEEWWWEWEWEWEWWEEWWEWWEEWWEWWWEEEEEEEWWEWEWWWWEWWEEWEWEWWEEEWEEWWWWWWEEWEWWEWWEWWEWWEWWEWE
WWWWEWWEWWEWEWEWWWEEWEEWWEWWWEWEWEWWWEWWEWEWEWEWEWEEWEEWWEWEWWEWEWWWEWEEEWEEEWEEEWWWWWWEEWEEWWEEWEEEWWEWWEWEWWEWWEWEEEEWWEWEWWEWWEWEWEWEEWEW
EWEEWWEWEWEWEWWEEEWWEWWEEWEEEWEWEWEWEWEEWEWWEWEWEEWEWWEEWWWEWEWEWEWEWWWWEWWWWEWWWEEWEEWWWEWWEEWWWWWEWEWEWEWWEWEEEWEWWWEEWEWEEWEWWEEWWEEWWEWE
EWEWWEEWEWWEWEWEWWEEWEEEWWEWWEWEWEWEEWEWWEWWEWWEWWWWWEEWWEEWEEWWEEWEWWEEWEWEEWEWEEWEWWWEWEWEEWEEEEEWWEWWWWEEEWEWWEWEWEWWEWEEWEWEEEWWEWWEEEWE
EEWEEWWEWWEWEWEWEWWWWWWEEEWWEWWEWEWWWWEEWWWEWEWEEEWEEWWEEWEWWWEEWEWEEEWEWWEWEWEWWWWEEEWEWEEWEWWWWWEWEWEEEEWWEWEWEWEWEWEWEWWWWEWWWWWEWEWWWEEW
EWWEWWWEWEEWWEEWWEWEEEWWWWWEWEWEWWEWEEWWEEEEWWWWWWWEWWEEWEWEEWEWEWWEWWWEWWEWWEWEWEEWWWEWWEWWWWEEEEWEEWEWWWWWEWWEWWEWEWEWEWWEEWWEWWEEWEWEEWWE
EEEWWEEWEWWEWWEEWEEWWEWEEEWEEWWEWWEEWEEWWWWWEEEWEEWEEWWEWWWWEEWWEEEWEEWEWEWEEWEWEWEEWEWWWEWEEEWWWEWWWEWEEWEWEEEWEWEEWEWEWWEWEEWEWEWWEWEWWEWE
EWWEWEWWWEWEWEEWEWWEWEWEWWEWWEEWEWWWWWWEEWEWEWWEEWEWWEWEWEEEWWWEWWWEWWEWWEWEWWEWEWWWEEWEEWEWWWEEWEWEWEWEWEEWWWWEEWWWEWWEWEEWWWEWWEWWEWWEEWWE
EEWWEWEEWEWEEWWEWEEWEWWEEWEEWWWWEWEEEWEWEWWEWEWWWEWEWEWEEWWEEEEWEEWEEWWEEWEWWEWWEEEWWWEWEWEWEWWEWEEWEWEWEWEWEEWWWWEWEWWEEWEWEWEWWEEWEWWWEEWE
EWEEWEEWEWEWWWWEWEWWEWEWWEWWEEEEWEWWWEWEWWEEWWEEEWEWWWEWWWEWWWWWEWEWWEWEWEWEEWEEWWWEEWEWWEWEWEWEWWWWEWEWEWWWEWEEWEEWEWEWWWEWWEWEWEWEWEEEWWEE
WWWEWWWEWWEEEWEWEWEWEWEEWEEWWWWEEWEWEWWEWEWWEEWWWWEEWWEEEEWWEEWEWWEWWEWEWEWWEWWEWWEWWWEEWEWEWEEWWEEEWWEWEEEEWEWEWWEEWEWEEWEWEWWEWEWEWWWEEWWE
WEEWEEWEWEWWWEWEWEEWWEWWWEWEWEEWWWEWEWEWEWEWEWWEEWWWEWEWWWEWEWEWEEWEWEWWEWEEWEWEWEEWEEEWWWEEWEWWWEWWWWEWWWWWWEWEWEEWWEWEWEWEEWEWEWWEWEWEWWWE
EWWWWEWEWEEWWEWEWWWWEWEEWEWEEWEWEWEWEWWEWWEWEWEWEEWWEWEEWWWEWWEWWEWEWEEWEWWWEWEWEWWEWWWEEWWWEWWEEWWEEWEEWEWEWWEWEWWEEWWEWEWWWAWWEEWEEWWEEEEW
WEEEEEWEWEWWEEWEWEEEEWEWEWEWWWWEEWEWEWEWEEWEEWEWWWEWEWEWEEEWEWWEWEWWEWWEEWEEWEEWEWWWEEWEWWWEEWWEWWEEWWWWEWEEWEEWWEEEWWWEWWEEWEEEWWEWWEEWWWWE
WWWWWEEWEWEEWEWEEWWWWEWEWWWEEEEWWWEEWEWWWEWWEWEEWEWEWEWWWWEWEEWEEWEWEEWWEWWWWWEWEEEEWWEWEEEWWWEWEWWEWEEWEEWWEWEWWWWEEEWEWEWWEWWEEEWEWWEEEWWE
WEEEWEWWWEWWEWWWWEWEEWEWEWEEWWWWWEEWEWEWEWEWWEEWWEWWEWWWEEWEEWEWWEWEWWEWWEWWEEWEEWWWWEWEEWWEEEWEWEEEWEWEEWWWWEWWEEEEWWEEWWWWEWEWWWEEWWEWWEWE
EWWEEWEEWEWEWWEEWEWWWEWEWEWWEWEEEWWWWWEEWWEWWWEWEWEEWEEEWEWWWWWWWEWWEEWEWEEEWEWWWWEEWWEWWWEWWEWEEWWEWEWWWEEEWEEEWWWWEWWWEEWEWWEEWEWEWEWEEWWE
WEEWWWWWEEWEWWEWEWEWEEWEWWEWEWEWWEWEEEEWEWEWEEWWEWWWEWWWEWEWEEEEEWWEEWWEWWWWWEWEEEEWEWEWWEEWWEWWWWEEWWEWEEWWEWWWWEEEWEEWEWEWEWEWEEWEWEWEWEEE
WWEEWEEEWEWEWEWEWEWEWWWEWEWWEWEEWEEWWWWEWWEEWEWWEEEWEWEEWEWEWWWWEWEWWEWEWEEWWWEWWWWEWWWEEWWEEWWEEWWEWWEWWEWEWEWEEWWEWWWWEWEWWEWEWWWWEWEWWWWE
WEWWEWWWWEWEWEWWEEWWEEWEWEWEWEWWEWWWEEWWEEWWWEWEWWWEWEEWWWEEWEEEWEWEEWEEWEWEEWWEWEWEWEEEWEEWWEEEWEEWEWWEWWWWEWEEWEWWEEEEWEWEWEWWWEEEWEWEEEEW
EWEWEEEWWWEWEWEWWEEWWEWEWEWWEWEEWWWEWEWWWEEWWEEWWEEWWWWEEWWWWWWEWEWWEEWWEWWWEEWEEWEWWWWWEWEWEWWEWWWEWEWEEEEWEEWWWEWWWWWWEWWEWEWEEWWEWEWWWWEE
EWEWEWWWEEEWEWWEWWWEEWEWEWEWEWEWEEEWEWEEWWWEWEWWWEWWEEWEWEWEEWEWEWEWEWEEWEEWWWEEWWWEEEEWEWWEWWEWWEEEWWEWWWWEWWEEEWEEEWEWEWWEWEWEWWEEWWWEEWWW
EWEEWEWEWWWWEWWEWEEWWEWEWWEWEEWEWWEWEWWEEWWEWEEEWEEEWEWEWEEWEWEEWWEWWEWEWWEEWWWWEEWWWWEWEEWEEWEEEWWEWEWEWEWEEWWWEWWWEWEEWWEWWEWEEWWEEEEWEEWE
EWEWEWWEWEEEWEEWEWWWEEWEWWEWWWWWWWWEWEWWWEWEWEWWEWWWWEWEWEWWEWEWWEEWWEWEWEWWEEEWEWEWWWWEWWEWWEWWWEWEWEWEWEWEWWEEWEWEWEWWEWEWEEWEWEEWWWWWWWEE
EEWEWEWEEWWWEWWEWEWEWWEWWEWDEEEEEEWEWEWEEWEWEWEWEEWEEWEWWEWWEWEEEWWEEWWWWWEWWWEWEWEEEEWEWEWEWEEEEWWEEWEWWEWEWEWEWEWEWEWEWWEWWEEWEWWEEEEEWEWE
EWWEWEWEWEEEWEWWEWWEWEWEEWEWWWWWWWEEWEWEWEWEWWEWEWWEWWEWEWEEWEWWWEWEWEEEEEEWEWWEWEWWWWWWEWEEWWWWWEEWWWEWWWEEWWEWWEWEWEWWEWEWWWWEWWWEWWWWWEWE
WEEWEWWEWWWEWEWWEEEWEWEWEWEEEWEWEWWWEWEWWEWEWEWEWEEWWEWEWEWWEWEWWEWEWWWWWWEWEWEWWEEWEEEEWWWWEEEEWWEWWEWEEWWEWWEWWEEWWEEWEWEEEWWEEEEWWEEWWEWE
EEWEEWWEWEWEWWEEWWWEWWWWEWEWWEWWEWWWEWWWEWEEWEWWEEWWWEWWEWWEEWWEEWEEWEWEEWEWEWWEWEWWEWWWWEEEEWWWEWWEEEWEWEWWEWEWEEWWEEWEWEWWWEWWWWWWWEWEEWEW
WEWWWEEWWEEWEWWEWWEWEEEWEWEWWEEWEEEWEEEWEWWWWEEWWEWEWEWEWWEWWEEWEWWWWEWWEEWEWEEWWEWWEEWWEWWWEWEWEEWWWWWWWEEEWEWEWEWEWWEWWEWEWEEWEWEEEWEWEWEW
EWEEWEWEWEWWEWEWEEEWEWWWWEWEWWWEEWWWWWWEEWEEWEWWWEWEWEWWEEWEWEWEWEEWEWEWWWWWEWWEWWEEWWEEEWEEWEEWWWEEWEEEEEWWEWEWEWWEWWWEEWEWEEWEWWEWWEWWWEWE
WEWWEWWEWEEWWEWWWWEWEWEEEWEWEWEWEWEEWEWWEWWEWEEEEWEWEWWEWWEWEWEWWWEEWEWEEEWWEEWEEWWEEWWWWEWWWWWEWEWWEWWWWWEWEEWEWWWEEEWWWEWEWWWEEWEEWEEWEWWE
WEWEWEWEWEWWEEWEWWWEWEEWWWEWWEWEWWEWEEWEWEEEWEWWWWWEEWEEWWWEEWEWEWEWEEWEWWEWEWEWWEWEWEWEEWEEEEWWEWEWEWEEWEWEWWWEWEEWWWEEWEWWWEEWWEEWEWWEWWWE
EWWEEWEWEWEEWWEWEEEWWWWEEEWWEWWEWWEWWEEWEWWEWEWWEEEWWEWEEEWWWWEEWEWEWWEWEEWEWWEWEWEWWWEWEWWWWEEWEEWEWEWEWEWEEEEWEWEWEEWWEWEEEWEWWWWWWEWEEEEW
EWEEWWWWEWEWEEEWEWWEWEEEWWWWEWWEWEEWEWWEWEWEWWEWEWWWWEWEWWEEEWEWWEWEWWEWEWWWEWEWWEEWWEEWWEWEEEWEWWEWEEWEWEWWWWWWEWWEWWEWWEEWWWWEWEEEWEWEWWWW
WWWEEEEWEWWEWWWEWWWWEWWWWEEWEEEWEWWEWWEWWWWEEEWWEEEEWWWEWWWWWWEWEWEWWEWWWEWEWWEEWWEWEWWWEWEWWWWEWEWWWWWEWEWEWEEWEEWEEWEWWWWEEWWEEWWEWEEWEEEE
EEEEWWWEWEEEWWEEWEEWWEWEEEWEWWWWWEWEWEEWEEEWWWWEEWWWEEEEWEWEEWEWWWEWEEWEEWEWEWEWEWEWWEEEWWEWEEEEWEWWEEWEWWEEWEWWEWEWWEWEEEWEWEWWWEWEWWWWEWWW
WWWEWEWEWWWWWEWWEWEEEWEWWWWEEEEEEWEWEWWEWWEEEWEWWEEWWWWWWEEWEEWEEEWEWWEWEWEEWWEWEWEEWWWEWWEWWWWEWEEWWEWEWEWEWEWWEWWEWEWWWEEWEWEWWWEWWEEWEEWE
EEWEWEWWEEEWEEWEWEWWWWWEWEEWWWWWWWEWWEWEWEEWWWWEWEWEEWEEWEWWEWWEWWWEWEEWEWWWWWEWWEWWEWEWEWEWEEEWEEWEWWEWEWWWEWEWEWWEWEWEEWWEWEWEWEEWWEWEEWEW
WWEWEWWEWWWEWWEWEWWEEWEWEWEEWEEWEEWEWEWWEWEEEWEWWEWWEWWEWEEWEEWEEEWEEWWWEEEEEEWWWEWWEWEEWEWEWWEWEWWEWEWWEEWEWWEEWEEWWEEWEWEWWEEWEWWEEWEWEWEW
EWWEWEWEWEEEWWWEWEEEWEEWEWEWEEWWEWWEWWEEEWWWWEWEEWEWEWEEWWWEWWWWWWWEWEWEEWWWWWWEEEWEEWEWWEWWEWEWEEEWEEWWWWEEWWEWEWWEEWWWWEWWEEWWEWEEWWWWEWWE
EEWEWEEWEWWWEEEWEWWWWWWWWEWEWEWWEEEWEWWWWEWEWEWWEEWWEEWEEEWEEWEEEEEWEWEWWEWWEEWWWWEWWWEWEWEEWWEEWWEWWWEEWWWEEWEWEEWWEEEWWEWEWWEWEWWEEEWWEWWE
EWWEWEWWEWWWEWWWEWEEEEEEEWWEWWEEWWWEEWEEWWEEWEWEEWWEWWWEWWEWWEEWWWWEWEWEWWEWEWEEWWEWEEWEWEEWEWEWEWEWEEEWEEWEWWEWWWEWWWWEEWEWEEWWEWWEWWEEWEEW
EWEWEWEEWEEWEWEEWEWWWWWWEWEWEWWWEWEWEWWEEWWEWEWWEWEWEEWWEWEWEWWEEWWEWWWEEEWEWWWEWEWEWEEWEWWWWEWWEWWEWWWEWWEWEWEEWEWEEEEWEWEEWWEEWEEWEEWWWWEE
EWEWWWEWWEWEWEWWWEWEEEWEWEWEWEEEEWEWWEWEWWEEWWEEEWEWEWEWEWWEWWEEWWEEWEEEWWWWEWEWEEWWEWWWEWEEEEWEWEEWEWWEWWEWWEWWEWEWWWWEWWEWWEEWWEWWEWEWEEEW
WEWWEEWWEWEWWEEEEWEWWEWWEWWEEWWWEEWEWEWEEEWWEWWWWWEWEWEWEWWEEEWEWEWWEWWWWEEEWEWWWEEEWEEWEWWWWWWWWWEWEWEWEEWEEWWEWEWEWEWEEEWWEWEWWEWWWWWEWWWE
WEWEEWEWEWEWWEWWWWEWEWEEWEWWWWEEEWWWEWEEWWWEWEEWEEWEEWEWWEEEWWWEWEWEWEEEEEWWEEWEEWWWWWWWEWEEEWEEEEWEWEWEEWWEWEWEWEWWEEWEWWWWEWWWEEWEEEEWEWEW
EWWWEWWEWEWEEWWEEEWWWWWEWEWEEEWWWEEEWEWWEEWEEWWEWEWWWWEEEWWWEEWEWEWWWWWWWWWWWEEWEWWEEEEEWEWWWEWWWEWEWEWWWEWEWEEWEWEEWEWEEEWEWWEEWWEWWWWWWWEE
EWEEWEEEWWEEWWEEWWWEEEEWWEWEWWEEWEWWWWWEEWWEWEWWEWEEEWEWWWWEEWWWEWEEEEWEEWEEWEWWWWEEWWWWWWEEWWEWEWEWWWEWEWEEWWWWWEEWEWEWWWEWEWEWEWEWEWEEWEEW
EEWEWWWWEWWWWEWEWEEWWWEEWEWWWWWEEWWEEEEWEWEWWWEEWEWWEWWWEEEWEEEWWWWWWWEWEEWEWWEEWEWWWEEEEEWEWEWWEWEEEWEWWEWWEEEEWWWWWWEEWWWEWWWEWWEWEEWEWWEE
WWEWEEEEWEWEEWWWEWWEEWWWEEWEEEEEWEWEWWWEWWEWEEEWWWWEEWEEEWWEWWWEWEEWEWEWEWWEWWEWEWEWEEWWWWWEWEWEEWWWWEEWWEWEEWWWEWWEEEEWWEEWEEEWEWEWEWWWEEEW
EEWWWWWEWWEWEEEEWEWWEEEWWWEWWWWWWEEWWEWEEEWEWWWEEEWWEWWWEWWEWEEWEWEWWEWWWWWEWEWWEWEEWEWEEWWWEWEWEEEWEWWEEWEWEWWWEWEWWWEEEWEWWWEEWEWEWEWWWWEW
EWEWEWEWEWEWWWWWWWEEWWWEEWWEWWEEWEWWEEWEWWWWEWWEWWEWWEWWWWEEWEWEWEWEWEWWEEEWEEWEEWEWWWWEWEWEEWEWWWWEWEWEWEWWWEEEWEEWEEWWWWWEWEWWWEWEWEWEEEWE
WEWWEEWEWEWEEWEEWEWWWEWWEWEWEEWEEWWWWEEWEEWEWEEWEWEWEWEEWEWWWWEWWEWEEWEEWWEWWWEWEWEWEEWEWWEWWEWWEEWEWWEWEWEEWWWEWWWEWEWWEEWEEWEEWEWEWEEWWEWE
EEWEWWEEWEWEWEWWEEWEEEWEWEWWEWEWWWEEEWWWEWEWEEWEWWEWWEEWEEWWEEEWWWEWWWWWEEWEWWWWEWWEEWEWEEWEEWWEEWEWEWEWEWWWEEEWEEWWEWEWEWWEWWEWEWEWEEWEWWWE
WEEWEWWEWEWEWEEEWEEWWEEWWEEWWWEWEEWWEWEWEWEWWWEWWEWEWWWWWWWEWWWEEEWEEEWEWEWWEEEEWEEWEWEEWWWWEWEWWEWEWEWEWEEEWWWWWEWEWEWEWEEWEWEWEWEEWEWEWEEW
WEWWEWWEWWEEWWWWEWWWEWWEWEWEEEEWEWWEWEWWEWWEEWEWEEWEWEWEWEEEWWEEWWWEWWEEWWWEEWWWWWWEWWEWEEEEWEEWWEWEWEWEWEWWWEEEEEWEWEWEWEWWWWWEWEWWEWEWWEWW
EWEWEEWEWWWWEWEWEWEWEEEWWEWWWWWWEEWEWEEWEWWWEWWEWWWEEWEWEWWEWEWWEWWEEWWEWEEWEWEEWEEWEEWEWWWWWWWEEWEWEWWEWEWEEWWWWWEWWEEWEWEEEEWEWEEWEWEEWEEW
EWWEEWEWEEEEEWEWWEWEWWWEEWEEEWEEWWEWEWWEEWEWEWEWEEWWWWEWEWEWWWEEWEEWWEWEWEWWWWEWWEWWEWWEWEWEEWEEWWWEEWWEWEWEWWEEWEWEWEWEWEEWWWEEWWWEWWEWEWWE
EWEWEWEWWWWWEWEEEWWEEWEWEWWWEEWEEWEWEWWWEWEWEWEWWEEEEWEWEWEEEEWEWWWEEWEWWEWEEEWEWEWEWWWEWEEWEEWWEWWWEEWEWEWEEWWEEWEWWWWEWWWWEWWWEWEWWWEWEEWE
WEWWEWEWWEEWEWEWWWWEWWEWEWEWEWWEWWWEWEWEWWEWEWWEEWWWWEEWEWEWWWEWWEEWWWEWEEWWWWEWEEWWWEEWEWWEWWEEEWEEWWEWEWEWWEWEWWWEEEWWWEEWEWWWEWEWEEWWEWWE
WEEEWWEEWWEWEWEWWEEWWEWWWEWEWEWWWEEWWEEWEEWWEWWWEEEWEWEWEWWWWEWWEWEEEWEEWEEEWWEEWWWEEWEWEWEWEWWWWEWWEEWWEWEWEWEWEEWWWEEEEWEEWEEEWEWEWEEWEWWE
EWWWEWWWEEEWWEEWEEWEEWEWEEWWEWWEEEWWEEWWEWEEWEEWEWWEWEWWEWEEEEWEEWEWWEWWWEWWEEWWEEEEWWEWWWEWEWEEEEWWEWWWEWEWWEWEEWWWEWWWWEWWWEWWEWEEWWWEWWEE
EEEWEWEWWWEEWWWEWEWWEEWEWEWWEWEWWWEWWEEEWEWEWWEWWWWEEWEWEEWWWWEWWWEWWEEWEWWEWEEWWWWWWEWEEWEEWEWWWWEWEEEWEWEEWEWWEEWEWWEEWEWEEWWEWWWWEEWEWEWE
EWWEWEWEWWEWEWEWEWWEWWEEWWEWEWWEWEWEWWWWWEWWEWWEWEEEWWWWEWEEEEWEWEEWEEWWWEWEWEWEWEWEEEWEWEWWEWEEWWEWWWWEWEEWWEWEEWEEWWEWEWEEWWEWEWEEEWEWEWEW
EEWEEWWEEEWEWWEWEWEWEWWWWWWWEEWEWEWEEEWWEWEWEEWEEWWWEEWEWWWWWWEWEWWWWWEEWWEWEWWEWWEWWWWEWWWEWWWEWEWEEWWEWWEWEWEWWEWWEEWEWWWEWWEWEEWWWEWWEEWE
EWWEWWEWWWWEWEEWEWEWEWEEEEEWEWEWEWEEWWEWEWEWEWEWWWWWEWEWEWEWEWEWWEWEEEEWEEWWWWEEWEEWWEEWEEEWEEEWEEWEWEWWEWWWEWEWEEWWEWEWEWEWEEEWWWEWWEWWEWWE
WWEWEWEEWEWEEWEWEWEWWEWWWWEEWWWEWEWEWEWEWWWWEWEEEEEWEWWWEWEWWWEEWEEWWWEWWEEEWEWEEWEEEWEWWWEWWWEWWEEWEWEEWEEEWEWWWEWEWWEWWEWWWWWEEWEEWEWEWEWE
WEEWWEEWEWEEWWWWEWEWEEWEWWWWEEEWEEWWWEWEWWEEEWWWWWWWEWEEWEWEEEEWEWWWWEWEWWWWEWEWWWEWWWWEEWEWEWWEEWWWWEEWWEWWWEWEEWEEWEWEEWEEEWWEWEWWEWEEWWEE
EWEWEWWEWEWWEEEWEEWEWWWEEEWWWWWWWWWEEWWEWEWWWWEEEEEEWEWEEWWWWWWWEWEEWEWEEEWEWEWWEWEEEEWWEEWWEWWWEEWEWWEEWEWEEWEWEWWEEWWWEWWWEWEWEWEEWWWWWWWE
EWWWEWEWEWEWEWWEWWWEWEEEWWEEEWEEWEEEWWEEWEWEWEEWWWWWEEWWWWWEEEEEEWEWEWEWWWWEWWWEEWEWWWWEEWWEEWEWWWEWEWWWEWEWWWEWEWWEWEEEWEEWEWWWWEEWWEEWEEEE
EEWWEEWWEWEWEWWEWWEWEWWWEWWWEEWEEWWWEWWWWEWEEWWWEEWWWWEEWEEWWWWWEEWEWWEWEEEWEEWWEWEWEWEWEWEWEWEEWEWWEEWEWWEEWEWWEEWWEWWWWWEEWEEEEWWWEWEEWWWE
EWEEEWWEEWEWEWEWEEEWEWWEEWEEWWWEWWEWWEEEEEWEWWWEEWEEWWEWWEWWEEWWWWWEWWEWEWWWEWEWWEEWEWEWWEWWEWEWEEWEEWWEWEWWEWEEWWEEWWWEEEWWEEWWWWEWEWWWEEWW
EWWWEWEWWEWWEWEWWWWEWWEWWEWWEEEWEWEWWWWWWEWEEEWWWWWEWEWEEWEEWEEEEEWEWEWEWWEEWWEEWWEEWEWEWEEEWEWWWWWWEEWEWWWWEEWEEWWEWEEWWEEWEEWEEWEEWEEWWEEE
WWWWWWEWWEWEEWEWEEWEWWEWEWWWEWWWEWWEEEEEWWEWWWEEEEEEWEWEWEWWEWWWWWEWEEWEWEEWWEWWEEWWWEWEWEWWWWEEWWEEEWEWEWEEWWWWWWWWEEWWEEWEWWEWWEWWWWWEWEWW
EEEEWEWEEWEWWEWEWWEWWEWEWEEEWWWWEWEWWWWEWEWWEWWWWWWEEWEWWEWEWEEWEWEWWWEWEWEEWWWEWWEEWEWWEWEEWEWEWEWWWEWEWEWWEWEEEEEWWWEEWWEWEWEWEWEEEEWEEWEW
EWWWEWEWWWWEWEWEWEEWEEWWEEWWEEEEWEWEWEWWEEWWEWWWEWEEWWEWWWEWEEWEWWEWEEWEWWEWWEEWEWEWEWEWWEWWEWEWWEWWEWEWEWEWEWEWWWWEEEWWEWWWEWWEWWEWWWEEWWWE
EEEWEEWWEEEWEWEWWWEWWEEEWWEWWWWEWEEWWEEWWEEEWEEEWEWEWWWEEEWWWWEWEEWEWWEWWEWEEWWWEWWWEEWEEWEEWWEEWEEEWWWWEEWEWWEWEEWWWEWEWEEWEEWEEWEEWWWWWEEW
EWWEWWWWEWWWEWWWEEWEWWWWEEWEEEEWWEWWEEWEWEWWWEWWEEWEWEEEWWWEEWEWEWWEWEWEEWEWWEEEWEEEWWWWWWEWEWWWEWWWEWEEEWWEWEEWEWEWEWEWEEWEWWEEWEWWEWEEWEWE
EEWWEEEEWEEWEEWEWEWEEWEEWWEWWWEWEWEEWWWEWWWWEWEWWWWWEWWWWEWWEEWWEWWEWEWWEWEEWWWEWWWEEEWEEEWWEEWWEWEWEEWWWEWEWWEEWEWWEEWWWWEWEWWWEWEEWEWWEWWE
EWWEEWWWWEWEEWEEWEWEWWEWWEEWEWEWWEEWEEWWEEEEWEWEWWEEWEWEWEWEEWWEWEWWEWEEWEWWEEEWEWWWWWEEWWEWEWEWEWEWEWEWEWWWEWEWWEWEEWWEEWWEWWEEWEWWEEWEEWWE
EWEWWEEEWWEWWWWWEWEWWEWEEWWWEWEWWWWWWEEWWWWEWEWEEWWEWEWEWEEWEWEWEWEWEWWEWEEEWWEWEEEWWWWWEWWEWWWEWWEWWWEWEEWWEWEWEWEWEWEWEEEWEEWWEWWWWEEWWEEW
WEEWEEWWWEEWWEEWEWWEWEWEWWEWEWWEEWWEEWWEWEEWEWEEWEWEWEWWEWWEWWWEWEWEWEEEWWWWEWEWEWWWEEWEWEEWEEEEWWEWEEWEEWEEWEWWEWEWEWWEWWWEEWEWEWEEEWWWEEWE
EWEWWEWWEWWEEWEWEEWEWEWEWWEWEEWWEEEWEWWEEWEWEEWWWEEWWEWWEWEWEEEWEWWEEWWEWEWWEWWEWWWEWEWEEWEWWWWWEEWEWEWWWWWEEWEEWEWWEWEWWEWWWWEWEWWWEEEWWEWE
EWEWEWEWEWWEWEWWEWEWEWWEWEEWEWEEWWWWWEEWWWWEWWWEEEWEWEWEEWEWEWWEEWEEWEWEWWEEWWEEWEEEWWEEWWEWEEWWEWEWWWEEEEEWWWEWWWEWWEWEEWEWEEEWEWWEEWWEWWEW
EWEWWWEWEEWEWEEWWEWEWEWEWWEEWWWEWWEEWWEEEWEWEEWWWWEWWEWWEEWEWEWWWEWWEWWEWWWEEEWWEWWEEWWWEWEEWEEWEWEEEWWWWWEEEEWEEWEWEWWWEEWEWWWEWWEWWEEWEWEE
WEWEEEWEWWEEWEWEWEWEWEWEWEEWWEWEWEEWEEWWWEWWEWEEEEWEWEWWEWEWEWWEEWEWWEEWEEWEWWEEEWEWWEWEEWEWEWWEWEWWWEEEEWEWWWWWWEEWEWWEEWWEWWEWEWEWEEWWEWEW
WEWWWEWEEWWWEWEWEWEWEWEWEWWEWEWEWWEWWEEWEWEWEWWWWEWEWEEWWWEWEWEWEWEEWWWWWEWEEWWWEWWEEWEWWWEWEEWEEWEEWWWWEWEWEEEWEWWEWEEWWWWEWEWEWWEWWEEEWWEE
EWWEWEWEWEEEWWEWEWWEEWEWWEEWEWEEWEEWEEWWEWEWWEEEWEWWEWWEWEEWEWEWWWEWEWWEEWEWWEEWEWEEWEEWEEWEWWWEWWEWWEEEWEWEWWWEWEWEWEWEEEEWEEWEWEWEWEWWEWEW
EEEWEWEWWWWEEEWEWEWWEEWWWWEEWEWWEWWWWEEWEWEEWWWEWEEWWWWEEWWEWWEEEEWEWEEWEWEEWWEWWWWWWWEEWWWWEEWEWEWEEWWWWEWEWEEWEWWEWEWWWWEWWEWEWWWEWEWEWWEE
EWWEEWEWEWWEWWEWEWWWWWWEEWEWEWEWEWWEEEWWEWEWEWEEWWWEWEEEWWWWEEEWWWWEWEWWWEWWEEWWEEWEEWWWWEEWEWEEWWEEWEWWEEWWEEWWEWEWEWWEEEWWEEWWEEEWEWEWWWEW
EEWWEEWWEEEWEWEWEEEEEEEWEEWEWWEEWEEWWEEWEEWWEEWEEEWEEWWEEEEWWWWEEEEWWEEEWEEEWEEEWEEWEEEEEWEEWEWWEEWEWEEEWEEEWEEWEEWWEEEWWEEEWEEWWWEEWWEEEEWW
