DEEEEEEWEEEWEEEEEEEE
EEEEEEWEWEWEEEEEEEEE
EEEEEEEEWEWEWEEEWEEE
EEEEEEEWEWEEEEEEWEEE
EEEEEEEWEWEEEEEEWEEE
EEEEEEWEWEEEEEEWEEEE
EEEEEEWEWEEEEEEWEEEE
EEEEEWEWEEEEEEWEEEEE
EEEEEWEWEEEEEEWEEEEE
EEEEWEEEEEEEEWEEEEEA
