EEEWWEEEEEWWEEWEWEWEEWWEE
EWEWEWWWWEWEWEEWEWEWEWEWE
WEEWEWEEWWEEWWWWEWWEWEEWE
EWEWEEWEEWAWEEEWEEWEWWWEW
WEWWWWWEWWWEEWWEEWWEWWEWE
WEEEWEEWWEEWWEWWWEWEWEWWE
EEWWEEWEWEWWWWEEEEWEWWEWE
WEEWWWEWEWEEEWWWWEEWEWEEW
EEWWEWEWEWEWWWEEEWWEEWEWW
WEEEWWEWEWEEWEWWEEWWEWEEW
WEWWWDEWEWWWEEWEWWEWEWWWE
EWEEWEWWEEEWWWWEEWEEWEEWE
EWEWEEWEEWWEEWEEWEWWEWWEE
EWEWWWWWWWWWEEWWWWWEWEEWE
EEWEEEEEEEEEEWEEEEEEWEWEW
