EWEEEEEEEE
EEEEEEEEEE
EEWEEEEEEE
EEEEEEEAEE
EEEEEEEEEE
EEWEEEEWEE
EWEEEEEEEE
EEEWEEEWEE
EEEEEEEEEW
DEEWEEEEEE