EWEEEEEWEE
EEEEEEWEEE
EEWEEEWEEE
EEWEWEWAWE
EEWEWEWWEE
EEWEEEEWEE
EWWWEEEEEE
EEEWEEEWEE
EEEWEEEEEW
DEEWEEEEEE
