DEEEWWEEEEEEEEEEWEEEEEEEE
EEWWEEEEEEEEEEEEWEEEEEEEE
EEWWEEEEEEEEEWEEEWEEEEEEE
EEWEEWWWWWWEEWEEEWEEEEEEE
EEWEEEEEEEEEEEWEEWEEEEEEE
EEWEEEEEEEEEEEWEEWEEEEEEE
EEEWEEEEEEEEEEWEEWEEEEEEE
EEEWEWWWWWWEEWEEEWEEEEEEE
EEEWEEEEEEEEEWEEEWEEEEEEE
EEEWEEEEEEEEEEEEWEEEEEEEE
EEEEWEEEEEEEEEEEWEEEEEEEE
EEEEWWEEEEEEEEEWEEEEEEEEE
EEEEEWWWEEEWWWWWEEEEEEEEE
EEEEEEEWWWWEEEEEEEEEEEEEE
EEEEEEEEEEEEEEEEEEEEEEEEA
